Albany: Tried: 'albany'
Arkansas Pine Bluff: Tried: 'arkansaspinebluff'
Cal Baptist: Tried: 'calbaptist'
Connecticut: Tried: 'connecticut'
East Tennessee St.: Tried: 'easttennesseest'
FIU: Tried: 'fiu'
Florida Gulf Coast: Tried: 'floridagulfcoast'
IU Indy: Tried: 'iuindy'
Kansas City: Tried: 'kansascity'
LIU: Tried: 'liu'
Little Rock: Tried: 'littlerock'
Louisiana Monroe: Tried: 'louisianamonroe'
Loyola MD: Tried: 'loyolamd'
Maryland Eastern Shore: Tried: 'marylandeasternshore'
Mississippi Valley St.: Tried: 'mississippivalleyst'
Nebraska Omaha: Tried: 'nebraskaomaha'
North Carolina Central: Tried: 'northcarolinacentral'
Oakland: Tried: 'oakland'
Queens: Tried: 'queens'
SIUE: Tried: 'siue'
Saint Joseph's: Tried: 'saintjosephs'
Saint Louis: Tried: 'saintlouis'
Saint Mary's: Tried: 'saintmarys'
Saint Peter's: Tried: 'saintpeters'
Sam Houston St.: Tried: 'samhoustonst'
San Jose St.: Tried: 'sanjosest'
Seattle: Tried: 'seattle'
South Dakota: Tried: 'southdakota'
South Dakota St.: Tried: 'southdakotast'
South Florida: Tried: 'southflorida'
Southeast Missouri: Tried: 'southeastmissouri'
Southeastern Louisiana: Tried: 'southeasternlouisiana'
St. Thomas: Tried: 'stthomas'
USC Upstate: Tried: 'uscupstate'
